





              w w w w w w w w w w w w w w w w w w w w w w w w w w w w w w w w w w w w w w w w w w w w w w w w w w w w w w w w w w w w w w w w w w w w w w w w W
              W                                                                                                                                               W
              W                                                                                                                                               W
              W                                                                                                                                               W
              W                                                                                                                                               W
              W                                                                                                                                               W
              W                                                                                                                                               W
              W                                                                                                                                               W
              W                                                                                                                                               W
              W                                                                                                                                               W
              W                                                                                                                                               W
              W                                                                                                                                               W
              W                                                                                                                                               W
              W                                                                                                                                               W
              W                                                                       W W W W W W W W W W W W W W W W W W W W W W W W W W W W W W W W W W W W W 
              W                                                                       W                                   W                                   W
              W                                                                       W                                   W                                   W
              W                                                                       W                                   W                                   W
              W                                                     W W W W W W W W W W                                   W                                   W
              W                                                                       W                                   W                                   W
              W                                                                       W                                   W                                   W
              W                                                                       W                                   W                                   W
              W                                                                       W                                   W                                   W
              W                                                                       W                                   W                                   W
              W                                       W W W W W W W W W W W W W W W W W W W W W W W W W W W W W W W W W W W                                   W
              W                                       W                                                                                                       W
              W                                       W                                                                                                       W
              W                                       W                                                                                                       W
              W                                       W                                                                                                       W
              W                                       W                                                                                                       W
              W                                       W                                                                                                       W
              W                                       W                                                                                                       W
              W                                       W                                                                                                       W                                                                                                                                                            W
              W                                       W                                                                                                       W
              W                                       W                                                                                                       W
              W                                       W                                                                                                       W
              W                                       W                                                                                                       W
              W                                       W                                                                                                       W
              W                                       W                                                                                                       W
              W                                       W                                                                                                       W
              W                                       W                                                                                                       W
              W                                       W                                                                                                       W
              W                                       W                                                                                                       W
              W                                       W                                                                                                       W
              W                                       W                                                                                                       W
              W                                       W                                                                                                       W
              W                                       W                                                                                                       W
              W                                       W W W W W W W W W W W W W W W W W W W W W W W W W W W W W W W W W W W W W W W W W W W W W W W W W W W W W                                                     W                                                                                                                                                            W
              W                                                                                                                                               W
              W                                                                                                                                               W
              W                                                                                                                                               W
              W                                                                                                                                               W
              W                                                                                                                                               W
              W                                                                                                                                               W
              W                                                                                                                                               W
              W                                                                                                                                               W
              W                                                                                                                                               W
              W                                                                                                                                               W
              W                                                                                                                                               W
              W                                                                                                                                               W
              W                                                                                                                                               W
              W                                                                                                                                               W
              W                                                                                                                                               W
              W                                                                                                                                               W
              W                                                                                                                                               W
              W w w w w w w w w w w w w w w w w w w w w w w w w w w w w w w w w w w w w w w w w w w w w w w w w w w w w w w w w w w w w w w w w w w w w w w w W 
